[reasoning] Repeat exactly: RYEIDT	RYEIDT
[reasoning] Repeat exactly: BMSTGD	BMSTGD
[reasoning] Repeat exactly: YZFQXP	YZFQXP
[reasoning] Repeat exactly: NUBZAY	NUBZAY
[reasoning] Repeat exactly: SBDDBH	SBDDBH
[reasoning] Repeat exactly: CYDDRP	CYDDRP
[reasoning] Repeat exactly: AVUSPZ	AVUSPZ
[reasoning] Repeat exactly: BAQCXZ	BAQCXZ
[reasoning] Repeat exactly: OARFSC	OARFSC
[reasoning] Repeat exactly: LCFMFA	LCFMFA
[translation] Repeat exactly: HTGKNN	HTGKNN
[translation] Repeat exactly: WQJMCR	WQJMCR
[translation] Repeat exactly: AYLZMS	AYLZMS
[translation] Repeat exactly: RVQERU	RVQERU
[translation] Repeat exactly: INWPWK	INWPWK
[translation] Repeat exactly: HJUGKM	HJUGKM
[translation] Repeat exactly: AFVEIK	AFVEIK
[translation] Repeat exactly: BXVZJW	BXVZJW
[translation] Repeat exactly: KKTFEP	KKTFEP
[translation] Repeat exactly: KSUWZU	KSUWZU
[math] Repeat exactly: YPZFPQ	YPZFPQ
[math] Repeat exactly: FRBJWW	FRBJWW
[math] Repeat exactly: DHERNK	DHERNK
[math] Repeat exactly: RABVNP	RABVNP
[math] Repeat exactly: RITFXT	RITFXT
[math] Repeat exactly: WUSQXB	WUSQXB
[math] Repeat exactly: RWEJTU	RWEJTU
[math] Repeat exactly: BOFIKC	BOFIKC
[math] Repeat exactly: EQKRKX	EQKRKX
[math] Repeat exactly: HGGWBI	HGGWBI
[coding] Repeat exactly: NBDFCX	NBDFCX
[coding] Repeat exactly: JQLNVX	JQLNVX
[coding] Repeat exactly: VVIRTQ	VVIRTQ
[coding] Repeat exactly: IBOZGS	IBOZGS
[coding] Repeat exactly: AUQHCH	AUQHCH
[coding] Repeat exactly: CBWFVL	CBWFVL
[coding] Repeat exactly: ICPTWL	ICPTWL
[coding] Repeat exactly: WQTJCB	WQTJCB
[coding] Repeat exactly: USSRWM	USSRWM
[coding] Repeat exactly: BILTZK	BILTZK
[context] Repeat exactly: RCOJOR	RCOJOR
[context] Repeat exactly: PXTDRG	PXTDRG
[context] Repeat exactly: FQLVQY	FQLVQY
[context] Repeat exactly: YQGULN	YQGULN
[context] Repeat exactly: EHJEKY	EHJEKY
[context] Repeat exactly: TCCOEC	TCCOEC
[context] Repeat exactly: HHCLDS	HHCLDS
[context] Repeat exactly: ZVFNNJ	ZVFNNJ
[context] Repeat exactly: NYQFRV	NYQFRV
[context] Repeat exactly: YCXPZS	YCXPZS
